NO texture/dirt.xpm
SO texture/gold_ore.xpm
WE texture/iron_ore.xpm
EA texture/diamond_ore.xpm

F 153,153,153
C 000,153,255


  11111
  1N001
  11111 